####################################################################################################
#          #             #                       #                 #                               #
#          #             #                       #                 #                               #
#          #             #                       #                                                 #
##### ########           #                       #                 #                               #
#                        ###### ########### ######                 #                               #
#            #############           #           #                 #                               #
#                        #           #           ########## ########                               #
##############           #           #           #                 #################################
#                        #           #                                 #           #               #
#                        #           #           #                                                 #
#                        #           ########## ##                     #           #               #
#                                    #           #                     #############               #
#                        #           #           #                     #                           #
##########################           #############                     #                           #
#              #                          #                            #############################
#              #                          #                            #                           #
#                                                                                                  #
#              #                          #                            #                           #
####################################################################################################